156
B                                                                                   BBBBBBB                                              BBBBBBBBBBBBBBBBBB
B                                                                                        BB                                                    BBBBBBBBBBBB
B                                                                                        BB        BB     E      BB                              BBBBBBBBBB
B                                                                                        BB        BB            BB                              BBBBBBBBBB
B                                                                                        BB         BBBBBBBBBBBBBB BBB                              BBBBBBB
B                                                                                B   E   BB         BBBBBBBBBBB   BBBBBBBB                            BBBBB
B                                                                                B       BB                            BB                               BBB  
B              B       E      BB                                                BBBBBBBBBBBB                           BB                               BBB
B              B              BB                                              BBBBBBBBBBBBBB                           BBBBBBBBBBBBBBBB                 BBB
B              BBBBBBBBBBBBBBBB                                            BBBBBBBBBBBBBBBB                            BBBBBBBBBBBBB     BB             BBB
B            BBBBBBBBBBBBBBBBBB                                                                                                               BB E      BBB
B           BBB                                            B    E     BB                                                                     BBBB       BBB
B          BBB                                             B          BB                                                                      BBBBBBBBBBBBB              
B         BBBB                                            BBBBBBBBBBBBBB                                                              BB   BBBBBBBBBBBBBBBB
B        BBBBB      BB        E   E                      BBBBBBBBBBBBBBBBBB                                                           BB                BBB
B  P    BBBBBB E    BB                                  BBBBBBBBBBBBBBBBBBBB                 E                      E                 BB               BBBB
B     BBBBBBBB      BBBBBBBBBBBBBBBBBBBBBBBBBBBBBBBBBBBBBBBBBBBBBBBBBBBBBBBBBBB                                                       BB               BBBB
BBBBBBBBBBBBBBBBBBBBBBBBBBBBBBBBBBBBBBBBBBBBBBBBBBBBBBBBBBBBBBBBBBBBBBBBBBBBBBBBBBBBBBBBBBBBBBBBBBBBBBBBBBBBBBBBBBBBBBBBBBBBBBBBBBBBBBBBBBBBBBBBBBBBBBBBBBB